+--+--+--+--+--+--+--+--+--+--+
|p    |              |        |
+  +--+--+--+  +--+  +  +  +--+
|           |  |     |  |     |
+--+--+--+  +  +  +--+--+--+  +
|        |  |  |              |
+  +--+  +  +  +--+--+--+--+  +
|     |  |  |  |           |  |
+--+  +--+  +  +  +--+--+  +--+
|     |     |           |     |
+  +  +  +--+--+  +--+--+  +  +
|  |  |        |  |     |  |  |
+  +--+--+--+  +--+  +  +--+  +
|           |        |        |
+  +  +--+  +--+--+--+--+--+  +
|  |  |     |           |     |
+  +  +  +--+  +--+  +  +  +--+
|  |  |  |  |  |  |  |  |  |  |
+  +  +  +  +  +  +  +--+  +  +
|  |  |     |     |     |  |  |
+--+  +--+  +--+  +--+  +  +  +
|     |        |  |  |     |  |
+  +--+--+--+  +  +  +--+--+  +
|           |  |  |        |  |
+  +--+--+  +  +  +--+  +  +  +
|        |  |  |     |  |  |  |
+--+--+  +  +--+--+  +  +  +  +
|     |  |  |        |  |  |  |
+  +  +--+  +  +--+--+  +  +  +
|  |  |     |           |     |
+  +  +  +  +--+--+--+--+--+  +
|  |     |  |  |        |     |
+  +--+--+  +  +  +--+  +  +--+
|        |     |  |  |     |  |
+  +--+  +--+--+  +  +--+--+  +
|  |  |     |     |           |
+  +  +--+  +  +--+--+  +  +--+
|        |     |     |  |     |
+--+--+  +--+--+  +  +--+--+  +
|                 |          g|
+--+--+--+--+--+--+--+--+--+--+