+--+--+--+--+--+
|p          |  |
+  +--+--+  +  +
|  |     |     |
+  +  +  +--+--+
|  |  |        |
+  +  +--+--+  +
|  |        |  |
+  +--+--+  +  +
|             g|
+--+--+--+--+--+
