+--+--+--+--+--+
|p       |     |
+  +--+  +  +  +
|     |  |  |  |
+  +  +--+  +  +
|  |        |  |
+  +--+--+--+  +
|  |     |     |
+  +  +  +--+--+
|     |        |
+--+--+--+--+  +
|     |     |  |
+  +  +--+  +  +
|  |        |  |
+  +--+--+  +  +
|     |     |  |
+  +  +--+--+  +
|  |  |        |
+  +  +  +--+--+
|  |          g|
+--+--+--+--+--+